9 5
0 0 0 0 0 0 0 0 0
0 1 1 1 1 1 1 1 0
0 1 1 1 1 1 0 1 2
0 1 1 1 1 1 1 1 0
0 0 0 0 0 0 0 0 0
2 2
3
0 4 1
0 4 2
0 4 3