8 5
0 0 0 0 0 0 0 0
0 1 1 1 1 1 1 0
0 1 1 1 1 1 1 2
0 1 1 1 1 1 1 0
0 0 0 0 0 0 0 0
2 2
3
1 3 1 2
1 3 3 0
2 5 2 0