9 7
-1 0 0 0 0 0 0 0 -1
-1 0 1 1 1 1 1 0 -1
0 0 1 0 1 0 1 0 0
0 1 1 1 1 1 1 1 2
0 0 1 0 1 0 1 0 0
-1 0 1 1 1 1 1 0 -1
-1 0 0 0 0 0 0 0 -1
1 3
3
3 6 1 3
3 7 3 3
3 6 5 3