5 9
0 0 0 0 0
0 1 1 1 0
0 1 1 1 0
0 1 1 1 0
0 1 1 1 0
0 1 1 1 0
0 1 1 1 0
0 1 1 1 0
0 0 2 0 0
2 3
6
1 2 1 2
1 2 5 0
3 1 1 2
3 3 5 0
3 1 5 0
3 3 1 2