9 8
0 0 0 0 0 -1 -1 -1 -1
0 1 1 1 0 -1 -1 -1 -1
0 1 1 1 0 -1 -1 -1 -1
0 1 1 1 0 0 0 0 0
0 1 1 1 1 1 1 1 0
0 1 1 1 1 1 1 1 2
0 1 1 1 1 1 1 1 0
0 0 0 0 0 0 0 0 0
2 2
3
3 4 4 3
3 2 6 0
6 6 5 3