13 5
0 0 0 0 0 0 0 0 0 0 0 0 0
0 1 1 1 1 1 1 1 1 1 1 1 0
0 1 1 1 1 1 1 1 1 1 1 1 2
0 1 1 1 1 1 1 1 1 1 1 1 0
0 0 0 0 0 0 0 0 0 0 0 0 0
6 2
8
4 2 1 1
4 3 2 2
4 2 3 3
4 1 2 0
4 9 1 2
4 11 1 3
4 9 3 1
4 11 3 0