6 8
0 0 2 0 0 0
0 1 1 1 1 0
0 1 1 1 1 0
0 1 1 1 1 0
0 1 1 1 1 0
0 1 1 1 1 0
0 1 1 1 1 0
0 0 0 0 0 0
3 4
4
5 2 1 2
5 3 2 2
0 2 6
0 3 6