5 13
0 0 0 0 0
0 1 1 1 0
0 1 1 1 0
0 1 1 1 0
0 1 1 1 0
0 1 1 1 0
0 1 1 1 0
0 1 1 1 0
0 1 1 1 0
0 1 1 1 0
0 1 1 1 0
0 1 1 1 0
0 0 2 0 0
2 2
5
3 2 5 0
3 3 6 0
3 2 7 0
6 2 10 0