13 13
-1 -1 -1 -1 0 0 0 0 0 0 0 0 0
-1 -1 -1 -1 0 1 1 1 1 1 1 1 0
-1 -1 -1 -1 0 1 1 1 1 1 1 1 2
-1 -1 -1 -1 0 1 1 1 1 1 1 1 0
-1 -1 -1 -1 0 1 1 1 0 0 0 0 0
-1 -1 -1 -1 0 1 1 1 0 -1 -1 -1 -1
-1 -1 -1 -1 0 1 1 1 0 -1 -1 -1 -1
-1 -1 -1 -1 0 1 1 1 0 -1 -1 -1 -1
0 0 0 0 0 1 1 1 0 -1 -1 -1 -1
0 1 1 1 1 1 1 1 0 -1 -1 -1 -1
0 1 1 1 1 1 1 1 0 -1 -1 -1 -1
0 1 1 1 1 1 1 1 0 -1 -1 -1 -1
0 0 0 0 0 0 0 0 0 -1 -1 -1 -1
1 10
12
5 10 1 3
5 11 2 3
5 10 3 3
1 5 1 1
1 7 3 3
1 5 5 1
1 7 7 3
4 6 2 3
4 6 6 3
3 5 9 3
3 6 10 3
3 7 11 3