10 10
-1 -1 -1 -1 -1 0 0 0 2 0
-1 -1 -1 -1 -1 0 1 1 1 0
-1 -1 0 0 0 0 1 1 1 0
-1 -1 0 1 1 1 1 1 1 0
-1 -1 0 1 1 1 1 0 0 0
0 0 0 1 1 1 1 0 0 0
0 1 1 1 1 1 1 1 1 0 
0 1 1 1 0 0 1 1 1 0
0 1 1 1 0 0 1 1 1 0
0 0 0 0 0 0 0 0 0 0
1 8
2
6 8 1 3
6 8 8 0